അകലെ	അകലം എ
അക്ഷമയോടെ	അക്ഷമ ഓടെ
അമ്മ	അമ്മ -
അമ്മമാരാല്‍	അമ്മമാർ ആൽ
അമ്മമാരിലൂടെ	അമ്മമാരിൽ ഊടെ
അമ്മമാരില്‍	അമ്മമാർ ഇൽ
അമ്മമാരുടെ	അമ്മമാർ ഉടെ
അമ്മമാരെ	അമ്മമാർ എ
അമ്മമാരെയല്ല	അമ്മമാരെ അല്ല
അമ്മമാരോട്	അമ്മമാർ ഓട്
അമ്മമാരോളം	അമ്മമാർ ഓളം
അമ്മമാര്‍	അമ്മ മാർ
അമ്മമാര്‍ക്കായി	അമ്മമാർക്ക് ആയി
അമ്മമാര്‍ക്ക്	അമ്മമാർ ക്ക്
അമ്മയല്ലാത്തത്	അമ്മയല്ലാത്ത അത്
അമ്മയായത്	അമ്മയായ അത്
അമ്മയായി	അമ്മ ആയി
അമ്മയാല്‍	അമ്മ ആൽ
അമ്മയിലുള്ള	അമ്മയിൽ ഉള്ള
അമ്മയിലൂടെ	അമ്മയിൽ ഊടെ
അമ്മയിലൂടെയുള്ള	അമ്മയിലൂടെ ഉള്ള
അമ്മയിലേക്കുള്ള	അമ്മയിലേക്ക് ഉള്ള
അമ്മയിലേക്ക്	അമ്മയിൽ ഏക്ക്
അമ്മയിലോട്ടുള്ള	അമ്മയിലോട്ട് ഉള്ള
അമ്മയിലോട്ട്	അമ്മയിൽ ഓട്ട്
അമ്മയില്‍	അമ്മ ഇൽ
അമ്മയെങ്കില്‍	അമ്മ എങ്കിൽ
അമ്മയെയല്ല	അമ്മയെ അല്ല
അമ്മയെയല്ലയെന്ന	അമ്മയെയല്ല എന്ന
അമ്മയെയല്ലയെന്ന്	അമ്മയെയല്ല എന്ന്
അമ്മയെയല്ലാതെ	അമ്മയെയല്ല ആതെ
അമ്മയെയല്ലാത്ത	അമ്മയെയല്ല ആത്ത
അമ്മയെയല്ലെങ്കിലാണ്	അമ്മയെയല്ലെങ്കിൽ ആണ്
അമ്മയെയല്ലെങ്കിലെന്ന്	അമ്മയെയല്ലെങ്കിൽ എന്ന്
അമ്മയെയല്ലെങ്കില്‍	അമ്മയെയല്ല എങ്കിൽ
അമ്മയെയല്ലെന്ന	അമ്മയെയല്ല എന്ന
അമ്മയെയല്ലെന്നാണ്	അമ്മയെയല്ലെന്ന് ആണ്
അമ്മയെയല്ലെന്ന്	അമ്മയെയല്ല എന്ന്
അമ്മയോടുള്ള	അമ്മയോട് ഉള്ള
അമ്മയോടുള്ളത്	അമ്മയോടുള്ള അത്
അമ്മയോടൊപ്പം	അമ്മയോട് ഒപ്പം
അമ്മയോടൊപ്പമുള്ള	അമ്മയോടൊപ്പം ഉള്ള
അമ്മയോട്	അമ്മ ഓട്
അമ്മയോളം	അമ്മ ഓളം
അമ്മയോളമുള്ള	അമ്മയോളം ഉള്ള
അമ്മയ്ക്കായ	അമ്മക്ക് ആയ
അമ്മയ്ക്കായത്	അമ്മയ്ക്കായ അത്
അമ്മയ്ക്കായി	അമ്മക്ക് ആയി
അമ്മയ്ക്കായുള്ള	അമ്മയ്ക്കായി ഉള്ള
അമ്മയ്ക്കുള്ള	അമ്മയ്ക്ക് ഉള്ള
അവളുടെ	അവൾ ഉടെ
ആണുള്ള	ആണ് ഉള്ള
ആന	ആന -
ആനകളാല്‍	ആനകൾ ആൽ
ആനകളില്‍	ആനകൾ ഇൽ
ആനകളും	ആനകൾ ഉം
ആനകളെ	ആനകൾ എ
ആനകളോട്	ആനകൾ ഓട്
ആനകള്‍	ആന കൾ
ആനകള്‍ക്ക്	ആനകൾ ക്ക്
ആനയല്ല	ആന അല്ല
ആനയാണ്	ആന ആണ്
ആനയായ	ആന ആയ
ആനയില്ല	ആന ഇല്ല
ആനയില്‍	ആന ഇൽ
ആനയും	ആന ഉം
ആനയുടെ	ആന ഉടെ
ആനയുണ്ട്	ആന ഉണ്ട്
ആനയുള്ള	ആന ഉള്ള
ആനയെ	ആന എ
ആനയെക്കൊണ്ട്	ആനയെ കൊണ്ട്
ആനയെന്ന്	ആന എന്ന്
ആനയെല്ലാം	ആന എല്ലാം
ആനയേ	ആന ഏ
ആനയോട്	ആന ഓട്
ആനയ്ക്ക്	ആന ക്ക്
എന്നുള്ള	എന്ന് ഉള്ള
എല്ലാമായ	എല്ലാം ആയ
എല്ലാമുള്ള	എല്ലാം ഉള്ള
കിണറിൽ	കിണർ ഇൽ
കുരങ്ങന്മാർ	കുരങ്ങൻ മാർ
കുഴിആനയ്ക്ക്	കുഴിആന ക്ക്
കൊണ്ടുള്ള	കൊണ്ട് ഉള്ള
കൊണ്ടെന്ന്	കൊണ്ട് എന്ന്
കൊണ്ടെല്ലാം	കൊണ്ട് എല്ലാം
ക്ഷമ	ക്ഷമ -
തട്ടിൽ	തട്ട് ഇൽ
തേനിൽ	തേൻ ഇൽ
ദയ	ദയ -
പപ്പടം	പപ്പടം -
മകനെ	മകൻ എ
മനസോടെ	മനസ് ഓടെ
മനുഷ്യനാൽ	മനുഷ്യൻ ആൽ
മനുഷ്യന്മാർ	മനുഷ്യൻ മാർ
മരം	മരം -
മരങ്ങള്‍	മരം കൾ
മരത്താല്‍	മരം ആൽ
മരത്തിന്	മരം ഇന്
മരത്തിന്റെ	മരം ഇന്റെ
മരത്തില്‍	മരം ഇൽ
മരത്തെ	മരം എ
മരത്തോട്	മരം ഓട്
മരമല്ല	മരം അല്ല
മരമാണ്	മരം ആണ്
മരമായ	മരം ആയ
മരമില്ല	മരം ഇല്ല
മരമുണ്ട്	മരം ഉണ്ട്
മരമുള്ള	മരം ഉള്ള
മരമെന്ന്	മരം എന്ന്
മരമെല്ലാം	മരം എല്ലാം
മരമേ	മരം ഏ
മരവും	മരം ഉം
മരുഭൂമിയിൽ	മരുഭൂമി ഇൽ
മരുമകനെ	മരുമകൻ എ
വണ്ടിയിൽ	വണ്ടി ഇൽ
വിധവമാർ	വിധവ മാർ
വിലങ്ങിൽ	വിലങ്ങ് ഇൽ
വീട്	വീട് -
വീട്ടിലെ	വീട്ടിൽ എ
വീട്ടില്‍	വീട് ഇൽ
